1111111111111
1001000P00001
1000011111001
1C0011E000P01
1111111111111
