1111111111111
10010E0000001
1000011111001
1PE011C000001
1111111111111
