111111111111111111
1P00C00C00C00C0XE1
111111111111111111
